#########################################
# #                  #                  #
# # #                #                  #
# # #           ###########             #
# # #                #                  #
# # #                #                  #
#   #                                   #
#########################################
